université	NOM	université
ouverte	ADJ	ouvert
:	PUN	:
de	PRP	de
18	NUM	@card@
h	ABR	heure
30	NUM	@card@
à	PRP	à
20	NUM	@card@
h	ABR	heure
30	NUM	@card@
maison	NOM	maison
des	PRP:det	du
associations	NOM	association
(	PUN	(
salle	NOM	salle
8	NUM	@card@
),	NOM	),
«	PUN:cit	«
la	DET:ART	le
franche-comté	NOM	franche-comté
et	KON	et
les	DET:ART	le
invasions	NOM	invasion
arabes	ADJ	arabe
»,	ADJ	»,
avec	ADV	avec
rené	VER:pper	renaître
locatelli	NOM	locatelli
,	PUN	,
professeur	NOM	professeur
émérite	ADJ	émérite
.	SENT	.
