dans	PRP	dans
le	DET:ART	le
cadre	NOM	cadre
des	PRP:det	du
sorties	NOM	sortie
sportives	ADJ	sportif
et	KON	et
culturelles	ADJ	culturel
,	PUN	,
les	DET:ART	le
jeunes	NOM	jeune
des	PRP:det	du
classes	NOM	classe
primaires	ADJ	primaire
du	PRP:det	du
groupe	NOM	groupe
scolaire	ADJ	scolaire
ont	VER:pres	avoir
passé	VER:pper	passer
une	DET:ART	un
journée	NOM	journée
formidable	ADJ	formidable
de	PRP	de
ski	NOM	ski
à	PRP	à
la	DET:ART	le
bresse	NOM	bresse
.	SENT	.
une	DET:ART	un
activité	NOM	activité
rendue	VER:pper	rendre
possible	ADJ	possible
grâce	NOM	grâce
à	PRP	à
la	DET:ART	le
participation	NOM	participation
financière	ADJ	financier
de	PRP	de
l'	DET:ART	le
association	NOM	association
gramgroums	NOM	gramgroums
.	SENT	.
des	PRP:det	du
souvenirs	NOM	souvenir
plein	ADJ	plein
tête	NOM	tête
.	SENT	.
