une	DET:ART	un
personne	NOM	personne
âgée	ADJ	âgé
de	PRP	de
73	NUM	@card@
ans	NOM	an
a	VER:pres	avoir
été	VER:pper	être
repêchée	VER:pper	repêcher
,	PUN	,
mardi	NOM	mardi
à	PRP	à
23	NUM	@card@
h	ABR	heure
50	NUM	@card@
dans	PRP	dans
un	DET:ART	un
étang	NOM	étang
situé	VER:pper	situer
sur	PRP	sur
la	DET:ART	le
commune	NOM	commune
d'	PRP	de
hérimoncourt	NOM	hérimoncourt
.	SENT	.
les	DET:ART	le
pompiers	NOM	pompier
dépêchés	VER:pper	dépêcher
sur	PRP	sur
place	NOM	place
n'	ADV	ne
ont	VER:pres	avoir
pu	VER:pper	pouvoir
que	KON	que
constater	VER:infi	constater
le	DET:ART	le
décès	NOM	décès
.	SENT	.
