le	DET:ART	le
conseil	NOM	conseil
municipal	ADJ	municipal
se	PRO:PER	se
réunira	VER:futu	réunir
mercredi	NOM	mercredi
12	NUM	@card@
février	NOM	février
,	PUN	,
à	PRP	à
20	NUM	@card@
h	ABR	heure
,	PUN	,
avec	PRP	avec
un	DET:ART	un
ordre	NOM	ordre
du	PRP:det	du
jour	NOM	jour
réduit	ADJ	réduit
qui	PRO:REL	qui
compte	VER:pres	compter
moins	ADV	moins
d'	PRP	de
une	DET:ART	un
dizaine	NOM	dizaine
de	PRP	de
questions	NOM	question
.	SENT	.
parmi	PRP	parmi
les	DET:ART	le
principales	ADJ	principal
,	PUN	,
le	DET:ART	le
programme	NOM	programme
de	PRP	de
travaux	NOM	travail
bois	NOM	bois
et	KON	et
forêt	NOM	forêt
.	SENT	.
