l'	DET:ART	le
usd	NOM	usd
organise	VER:pres	organiser
avec	PRP	avec
sa	DET:POS	son
nouvelle	ADJ	nouveau
équipe	NOM	équipe
dirigeante	NOM	dirigeant
son	DET:POS	son
grand	ADJ	grand
loto	NOM	loto
annuel	ADJ	annuel
,	PUN	,
samedi	NOM	samedi
1	NUM	@card@
e	NOM	e
r	VER:subi	r
février	NOM	février
,	PUN	,
à	PRP	à
partir	VER:infi	partir
de	PRP	de
18	NUM	@card@
h	ABR	heure
,	PUN	,
à	PRP	à
la	DET:ART	le
maison	NOM	maison
develçoise	ADJ	develçoise
.	SENT	.
lots	NOM	lot
intéressants	ADJ	intéressant
.	SENT	.
buvette	NOM	buvette
et	KON	et
restauration	NOM	restauration
sur	PRP	sur
place	NOM	place
.	SENT	.
