le	DET:ART	le
hall	NOM	hall
de	PRP	de
l'	DET:ART	le
hôtel	NOM	hôtel
:	PUN	:
le	DET:ART	le
luxe	NOM	luxe
sans	PRP	sans
tapage	NOM	tapage
.	SENT	.
hugh	INT	hugh
grant	NOM	grant
,	PUN	,
elisabeth	ADJ	elisabeth
hurley	NOM	hurley
et	KON	et
richard	NOM	richard
anconina	NOM	anconina
ont	VER:pres	avoir
fréquenté	VER:pper	fréquenter
le	DET:ART	le
majestic	NOM	majestic
,	PUN	,
comme	ADV	comme
tant	ADV	tant
d'	PRP	de
autres	ADJ	autre
vedettes	NOM	vedette
.	SENT	.
