suite	NOM	suite
à	PRP	à
la	DET:ART	le
cession	NOM	cession
d'	PRP	de
activité	NOM	activité
garage	NOM	garage
à	PRP	à
villotte	NOM	villotte
,	PUN	,
le	DET:ART	le
dépôt	NOM	dépôt
de	PRP	de
gaz	NOM	gaz
butane	NOM	butane
a	VER:pres	avoir
été	VER:pper	être
transféré	VER:pper	transférer
au	PRP:det	au
restaurant	NOM	restaurant
«	PUN:cit	«
le	DET:ART	le
brûlot	NOM	brûlot
»,	ADJ	»,
où	PRO:REL	où
l'	DET:ART	le
on	PRO:PER	on
peut	VER:pres	pouvoir
dès	PRP	dès
à	PRP	à
présent	ADJ	présent
s'	PRO:PER	se
approvisionner	VER:infi	approvisionner
.	SENT	.
