la	DET:ART	le
présence	NOM	présence
de	PRP	de
monoxyde	NOM	monoxyde
de	PRP	de
carbone	NOM	carbone
a	VER:pres	avoir
nécessité	VER:pper	nécessiter
l'	DET:ART	le
intervention	NOM	intervention
des	PRP:det	du
pompiers	NOM	pompier
,	PUN	,
hier	ADV	hier
vers	PRP	vers
19	NUM	@card@
h	ABR	heure
30	NUM	@card@
au	PRP:det	au
4	NUM	@card@
rue	NOM	rue
strolz	NOM	strolz
à	PRP	à
belfort	NOM	belfort
.	SENT	.
trois	NUM	trois
personnes	NOM	personne
ont	VER:pres	avoir
été	VER:pper	être
emmenées	VER:pper	emmener
au	PRP:det	au
centre	NOM	centre
hospitalier	ADJ	hospitalier
pour	PRP	pour
examen	NOM	examen
.	SENT	.
