le	DET:ART	le
concours	NOM	concours
annuel	ADJ	annuel
de	PRP	de
tarots	NOM	tarot
,	PUN	,
organisé	VER:pper	organiser
à	PRP	à
la	DET:ART	le
pomme	NOM	pomme
d'	PRP	de
or	NOM	or
,	PUN	,
rassemblera	VER:futu	rassembler
les	PRO:PER	la|le
passionnés	VER:pper	passionner
dimanche	NOM	dimanche
9	NUM	@card@
février	NOM	février
dès	PRP	dès
14	NUM	@card@
heures	NOM	heure
.	SENT	.
on	PRO:PER	on
pourra	VER:futu	pouvoir
se	PRO:PER	se
restaurer	VER:infi	restaurer
après	PRP	après
la	DET:ART	le
proclamation	NOM	proclamation
des	PRP:det	du
résultats	NOM	résultat
et	KON	et
l'	DET:ART	le
apéritif	NOM	apéritif
qui	PRO:REL	qui
suivra	VER:futu	suivre
.	SENT	.
on	PRO:PER	on
annonce	VER:pres	annoncer
un	DET:ART	un
lot	NOM	lot
pour	PRP	pour
chaque	PRO:IND	chaque
joueur	NOM	joueur
.	SENT	.
les	DET:ART	le
places	NOM	place
sont	VER:pres	être
limitées	VER:pper	limiter
.	SENT	.
réservations	NOM	réservation
au	PRP:det	au
03	NUM	@card@
81	NUM	@card@
92	NUM	@card@
52	ABR	@card@
92	NUM	@card@
