l'	DET:ART	le
ecran	NOM	ecran
mobile	ADJ	mobile
propose	VER:pres	proposer
«	PUN:cit	«
harry	NOM	harry
potter	NOM	potter
:	PUN	:
la	DET:ART	le
chambre	NOM	chambre
des	PRP:det	du
secrets	ADJ	secret
»	PUN:cit	»
jeudi	NOM	jeudi
16	NUM	@card@
janvier	NOM	janvier
,	PUN	,
à	PRP	à
la	DET:ART	le
salle	NOM	salle
des	PRP:det	du
fêtes	NOM	fête
de	PRP	de
deluz	NOM	deluz
,	PUN	,
à	PRP	à
20	NUM	@card@
h.	ABR	h.
entrée	NOM	entrée
adulte	ADJ	adulte
4,60	NUM	@card@
,	NOM	,
enfant	NOM	enfant
3,80	NUM	@card@
.	ABR	.
pour	PRP	pour
plus	ADV	plus
d'	PRP	de
informations	NOM	information
,	PUN	,
vous	PRO:PER	vous
pouvez	VER:pres	pouvoir
le	PRO:PER	le
contacter	VER:infi	contacter
au	PRP:det	au
03.84	NUM	@card@
.	SENT	.
96.09	NUM	@card@
.	SENT	.
18	NUM	@card@
