les	DET:ART	le
fêtes	NOM	fête
à	PRP	à
peine	NOM	peine
finies	VER:pper	finir
qu'	KON	que
on	PRO:PER	on
se	PRO:PER	se
laisse	VER:pres	laisser
déjà	ADV	déjà
tenter	VER:infi	tenter
immédiatement	ADV	immédiatement
par	PRP	par
de	PRP	de
nouvelles	ADJ	nouveau
gourmandises	NOM	gourmandise
...	PUN	...
les	DET:ART	le
élus	NOM	élu
du	PRP:det	du
village	NOM	village
ont	VER:pres	avoir
ainsi	ADV	ainsi
convié	VER:pper	convier
les	DET:ART	le
anciens	NOM	ancien
à	PRP	à
venir	VER:infi	venir
partager	VER:infi	partager
avec	PRP	avec
eux	PRO:PER	eux
l'	DET:ART	le
incontournable	ADJ	incontournable
galette	NOM	galette
de	PRP	de
l'	DET:ART	le
épiphanie	NOM	épiphanie
.	SENT	.
une	DET:ART	un
trentaine	NOM	trentaine
de	PRP	de
«	PUN:cit	«
gourmands	NOM	gourmand
»	PUN:cit	»
ont	VER:pres	avoir
répondu	VER:pper	répondre
à	PRP	à
cette	PRO:DEM	ce
généreuse	ADJ	généreux
initiative	NOM	initiative
.	SENT	.
en	PRP	en
ces	PRO:DEM	ce
temps	NOM	temps
de	PRP	de
froidure	NOM	froidure
,	PUN	,
rien	NOM	rien
de	PRP	de
tel	PRO:DEM	tel
que	PRO:REL	que
quelques	PRO:IND	quelque
sucreries	NOM	sucrerie
!	SENT	!
les	DET:ART	le
anciens	NOM	ancien
se	PRO:PER	se
sont	VER:pres	être
lancés	VER:pper	lancer
à	PRP	à
belles	ADJ	beau
dents	NOM	dent
à	PRP	à
la	DET:ART	le
recherche	NOM	recherche
des	PRP:det	du
fèves	NOM	fève
,	PUN	,
et	KON	et
les	DET:ART	le
plus	ADV	plus
chanceux	ADJ	chanceux
ont	VER:pres	avoir
été	VER:pper	être
vite	ADV	vite
couronnés	VER:pper	couronner
,	PUN	,
alors	ADV	alors
que	KON	que
l'	DET:ART	le
après-midi	NOM	après-midi
se	PRO:PER	se
déroulait	VER:impf	dérouler
gentiment	ADV	gentiment
sur	PRP	sur
des	PRP:det	du
airs	NOM	air
d'	PRP	de
autrefois	ADV	autrefois
...	PUN	...
