l'	DET:ART	le
association	NOM	association
du	PRP:det	du
fort	ADJ	fort
dorsner	NOM	dorsner
de	PRP	de
giromagny	NAM	giromagny
met	VER:pres	mettre
en	PRP	en
garde	NOM	garde
contre	PRP	contre
une	DET:ART	un
personne	NOM	personne
qui	PRO:REL	qui
collecte	VER:pres	collecter
actuellement	ADV	actuellement
des	PRP:det	du
fonds	NOM	fond|fonds
pour	PRP	pour
l'	DET:ART	le
association	NOM	association
et	KON	et
qui	PRO:REL	qui
n'	ADV	ne
est	VER:pres	être
pas	ADV	pas
mandatée	VER:pper	mandater
pour	PRP	pour
cela	PRO:DEM	cela
.	SENT	.
l'	DET:ART	le
association	NOM	association
rappelle	VER:pres	rappeler
que	ADV	que
seuls	ADJ	seul
gilbert	NOM	gilbert
demouge	NOM	demouge
et	KON	et
jean	NOM	jean
mickes	ADJ	mickes
sont	VER:pres	être
mandatés	VER:pper	mandater
pour	PRP	pour
de	PRP	de
telles	PRO:DEM	tel
démarches	NOM	démarche
.	SENT	.
