l'	DET:ART	le
hôpital	NOM	hôpital
universitaire	ADJ	universitaire
makassed	NOM	makassed
compte	VER:pres	compter
250	NUM	@card@
lits	NOM	lit
pour	PRP	pour
600	NUM	@card@
salariés	NOM	salarié
.	SENT	.
financé	VER:pper	financer
par	PRP	par
des	PRP:det	du
fonds	NOM	fond|fonds
internationaux	ADJ	international
et	KON	et
géré	VER:pper	gérer
par	PRP	par
une	DET:ART	un
ong	NOM	ong
,	PUN	,
il	PRO:PER	il
a	VER:pres	avoir
soigné	VER:pper	soigner
10.000	NUM	@card@
blessés	NOM	blessé
palestiniens	ADJ	palestinien
lors	ADV	lors
de	PRP	de
la	DET:ART	le
première	NUM	premier
intifada	NOM	intifada
et	KON	et
5.000	NUM	@card@
depuis	PRP	depuis
le	DET:ART	le
début	NOM	début
de	PRP	de
la	DET:ART	le
deuxième	NUM	deuxième
.	SENT	.
des	PRP:det	du
blessés	NOM	blessé
par	PRP	par
balle	NOM	balle
,	PUN	,
des	PRP:det	du
personnes	NOM	personne
prises	VER:pper	prendre
dans	PRP	dans
des	PRP:det	du
attentats	NOM	attentat
victimes	NOM	victime
des	PRP:det	du
traumatismes	NOM	traumatisme
.	SENT	.
il	PRO:PER	il
s'	PRO:PER	se
y	PRO:PER	y
pratique	VER:pres	pratiquer
une	DET:ART	un
moyenne	NOM	moyenne
de	PRP	de
600	NUM	@card@
accouchements	NOM	accouchement
par	PRP	par
mois	NOM	moi|mois
,	PUN	,
pour	PRP	pour
une	DET:ART	un
population	NOM	population
qui	PRO:REL	qui
subit	VER:simp	subir
un	DET:ART	un
état	NOM	état
de	PRP	de
stress	NOM	stress
permanent	ADJ	permanent
provoquant	VER:ppre	provoquer
un	DET:ART	un
nombre	NOM	nombre
impressionnant	ADJ	impressionnant
d'	PRP	de
infarctus	NOM	infarctus
chez	PRP	chez
les	DET:ART	le
moins	ADV	moins
de	PRP	de
35	NUM	@card@
ans	NOM	an
.	SENT	.
