dans	PRP	dans
le	DET:ART	le
cadre	NOM	cadre
du	PRP:det	du
centre	NOM	centre
de	PRP	de
loisirs	NOM	loisir
sans	PRP	sans
hébergement	NOM	hébergement
proposé	VER:pper	proposer
par	PRP	par
le	DET:ART	le
centre	NOM	centre
georges-brassens	ADJ	georges-brassens
durant	PRP	durant
les	DET:ART	le
vacances	NOM	vacance
de	PRP	de
noël	NOM	noël
,	PUN	,
les	DET:ART	le
stages	NOM	stage
de	PRP	de
tennis	NOM	tennis
de	PRP	de
table	NOM	table
ont	VER:pres	avoir
connu	VER:pper	connaître
un	DET:ART	un
franc	ADJ	franc
succès	NOM	succès
.	SENT	.
l'	DET:ART	le
organisateur	NOM	organisateur
,	PUN	,
cédric	NOM	cédric
brasseur	NOM	brasseur
,	PUN	,
dénombrait	VER:impf	dénombrer
une	DET:ART	un
bonne	ADJ	bon
vingtaine	NOM	vingtaine
d'	PRP	de
inscrits	NOM	inscrit
âgés	ADJ	âgé
de	PRP	de
7	NUM	@card@
à	PRP	à
16	NUM	@card@
ans	NOM	an
.	SENT	.
«	PUN:cit	«
une	DET:ART	un
bonne	ADJ	bon
moitié	NOM	moitié
des	PRP:det	du
jeunes	NOM	jeune
ne	ADV	ne
sont	VER:pres	être
pas	ADV	pas
adhérents	ADJ	adhérent
à	PRP	à
l'	DET:ART	le
activité	NOM	activité
tennis	NOM	tennis
de	PRP	de
table	NOM	table
du	PRP:det	du
centre	NOM	centre
,	PUN	,
la	DET:ART	le
plupart	NOM	plupart
d'	PRP	de
entre	PRP	entre
eux	PRO:PER	eux
m'	PRO:PER	me
ont	VER:pres	avoir
dit	VER:pper	dire
qu'	KON	que
ils	PRO:PER	il
aimeraient	VER:cond	aimer
participer	VER:infi	participer
maintenant	ADV	maintenant
aux	PRP:det	au
entraînements	NOM	entraînement
hebdomadaires	ADJ	hebdomadaire
»,	ADJ	»,
affirme	VER:pres	affirmer
fièrement	ADV	fièrement
l'	DET:ART	le
animateur	NOM	animateur
.	SENT	.
répartis	VER:pper	répartir
sur	PRP	sur
deux	NUM	deux
séances	NOM	séance
,	PUN	,
les	DET:ART	le
stages	NOM	stage
ont	VER:pres	avoir
pour	PRP	pour
but	NOM	but
de	PRP	de
faire	VER:infi	faire
découvrir	VER:infi	découvrir
ce	PRO:DEM	ce
sport	NOM	sport
aux	PRP:det	au
néophytes	NOM	néophyte
et	KON	et
de	PRP	de
perfectionner	VER:infi	perfectionner
les	DET:ART	le
coups	NOM	coup
tactiques	ADJ	tactique
et	KON	et
techniques	ADJ	technique
aux	PRP:det	au
habitués	VER:pper	habituer
de	PRP	de
la	DET:ART	le
petite	ADJ	petit
balle	NOM	balle
blanche	ADJ	blanc
.	SENT	.
service	NOM	service
,	PUN	,
lift	NOM	lift
,	PUN	,
volée	VER:pper	voler
,	PUN	,
revers	NOM	revers
...	PUN	...
tous	PRO:IND	tout
les	DET:ART	le
joueurs	NOM	joueur
ont	VER:pres	avoir
apprécié	VER:pper	apprécier
les	DET:ART	le
excellents	ADJ	excellent
conseils	NOM	conseil
du	PRP:det	du
professeur	NOM	professeur
.	SENT	.
des	PRP:det	du
stages	NOM	stage
qui	PRO:REL	qui
se	PRO:PER	se
sont	VER:pres	être
terminés	VER:pper	terminer
par	PRP	par
des	PRP:det	du
petits	ADJ	petit
matches	NOM	match
amicaux	ADJ	amical
mais	KON	mais
néanmoins	ADV	néanmoins
très	ADV	très
acharnés	VER:pper	acharner
.	SENT	.
