l'	DET:ART	le
association	NOM	association
des	PRP:det	du
carpiots	NOM	carpiots
invite	VER:pres	inviter
à	PRP	à
une	DET:ART	un
soirée	NOM	soirée
tarot	NOM	tarot
samedi	NOM	samedi
18	NUM	@card@
janvier	NOM	janvier
,	PUN	,
salle	NOM	salle
de	PRP	de
la	DET:ART	le
mairie	NOM	mairie
(	PUN	(
inscriptions	NOM	inscription
8	NUM	@card@
).	ABR	).
contacter	VER:infi	contacter
isabelle	ADJ	isabelle
martin	NOM	martin
au	PRP:det	au
03.83	NUM	@card@
.	SENT	.
62.89	NUM	@card@
.	SENT	.
14	NUM	@card@
au	PRP:det	au
plus	ADV	plus
tôt	ADV	tôt
,	PUN	,
les	DET:ART	le
places	NOM	place
sont	VER:pres	être
comptées	VER:pper	compter
.	SENT	.
