alix	NOM	alix
est	VER:pres	être
venue	VER:pper	venir
au	PRP:det	au
monde	NOM	monde
le	DET:ART	le
24	NUM	@card@
janvier	NOM	janvier
à	PRP	à
la	DET:ART	le
polyclinique	NOM	polyclinique
majorelle	ADJ	majorelle
de	PRP	de
nancy	NOM	nancy
,	PUN	,
pesant	VER:ppre	peser
alors	ADV	alors
2,970	NUM	@card@
kg	ABR	kg
et	KON	et
mesurant	VER:ppre	mesurer
47	NUM	@card@
cm	NOM	cm
.	SENT	.
deuxième	NUM	deuxième
enfant	NOM	enfant
de	PRP	de
caroline	ADJ	carolin
husson	NOM	husson
et	KON	et
laurent	VER:pres	laurer
petitpas	NOM	petitpas
,	PUN	,
elle	PRO:PER	elle
rejoindra	VER:futu	rejoindre
bientôt	ADV	bientôt
au	PRP:det	au
domicile	NOM	domicile
familial	ADJ	familial
,	PUN	,
avenue	NOM	avenue
du	PRP:det	du
général-leclerc	NOM	général-leclerc
,	PUN	,
sa	DET:POS	son
s	NOM	s
	ADJ	
ur	VER:simp	ur
jeanne	NOM	jeanne
.	SENT	.
nos	DET:POS	notre
félicitations	NOM	félicitation
.	SENT	.
