ils	PRO:PER	il
étaient	VER:impf	être
encore	ADV	encore
forts	ADJ	fort
nombreux	ADJ	nombreux
,	PUN	,
les	DET:ART	le
adeptes	NOM	adepte
de	PRP	de
jeux	NOM	jeu
de	PRP	de
hasard	NOM	hasard
à	PRP	à
s'	PRO:PER	se
être	VER:infi	être
déplacés	VER:pper	déplacer
à	PRP	à
l'	DET:ART	le
après-midi	NOM	après-midi
loto	NOM	loto
organisé	VER:pper	organiser
par	PRP	par
la	DET:ART	le
sympathique	ADJ	sympathique
association	NOM	association
locale	ADJ	local
«	PUN:cit	«
les	DET:ART	le
tavagnés	NOM	tavagnés
»	PUN:cit	»
il	PRO:PER	il
faut	VER:pres	falloir
dire	VER:infi	dire
que	KON	que
la	DET:ART	le
qualité	NOM	qualité
des	PRP:det	du
lots	NOM	lot
mis	VER:pper	mettre
en	PRP	en
jeu	NOM	jeu
ne	ADV	ne
pouvait	VER:impf	pouvoir
qu'	ADV	qu'
attirer	VER:infi	attirer
la	DET:ART	le
foule	NOM	foule
.	SENT	.
tous	PRO:IND	tout
très	ADV	très
attentifs	ADJ	attentif
aux	PRP:det	au
numéros	NOM	numéro
annoncés	VER:pper	annoncer
par	PRP	par
sono	NOM	sono
interposée	VER:pper	interposer
,	PUN	,
nos	DET:POS	notre
accrocs	NOM	accroc
très	ADV	très
disciplinés	VER:pper	discipliner
comptaient	VER:impf	compter
et	KON	et
recomptaient	VER:impf	recompter
le	DET:ART	le
nombre	NOM	nombre
de	PRP	de
cases	NOM	case
qui	PRO:REL	qui
leur	PRO:PER	lui
restaient	VER:impf	rester
à	PRP	à
recouvrir	VER:infi	recouvrir
avant	PRP	avant
de	PRP	de
pouvoir	VER:infi	pouvoir
crier	VER:infi	crier
«	PUN:cit	«
bingo	NOM	bingo
».	ADJ	».
et	KON	et
cette	PRO:DEM	ce
année	NOM	année
,	PUN	,
la	DET:ART	le
chance	NOM	chance
avait	VER:impf	avoir
un	DET:ART	un
tantinet	NOM	tantinet
choisi	VER:pper	choisir
son	DET:POS	son
camp	NOM	camp
parmi	PRP	parmi
les	DET:ART	le
jeunes	NOM	jeune
du	PRP:det	du
village	NOM	village
.	SENT	.
la	DET:ART	le
convivialité	NOM	convivialité
restait	VER:impf	rester
néanmoins	ADV	néanmoins
l'	DET:ART	le
enjeu	NOM	enjeu
premier	NUM	premier
de	PRP	de
cet	PRO:DEM	ce
après-midi	NOM	après-midi
hivernal	ADJ	hivernal
.	SENT	.
rendez-vous	NOM	rendez-vous
est	VER:pres	être
déjà	ADV	déjà
pris	VER:pper	prendre
pour	PRP	pour
un	DET:ART	un
prochain	ADJ	prochain
numéro	NOM	numéro
!	SENT	!
