nancy	NOM	nancy
.	SENT	.
-	PUN	-
les	DET:ART	le
dix	NUM	dix
jeunes	ADJ	jeune
boxeurs	NOM	boxeur
dombaslois	NOM	dombaslois
engagés	VER:pper	engager
en	PRP	en
finale	NOM	finale
des	PRP:det	du
championnats	NOM	championnat
d'	PRP	de
alsace-lorraine	NOM	alsace-lorraine
de	PRP	de
boxe	NOM	boxe
éducative	ADJ	éducatif
(	PUN	(
benjamins	NOM	benjamin
,	PUN	,
minimes	ADJ	minime
,	PUN	,
cadets	ADJ	cadet
)	PUN	)
ont	VER:pres	avoir
tous	PRO:IND	tout
été	NOM	été
sacrés	ADJ	sacré
vainqueurs	NOM	vainqueur
.	SENT	.
cinq	NUM	cinq
d'	PRP	de
entre	PRP	entre
eux	PRO:PER	eux
ont	VER:pres	avoir
gagné	VER:pper	gagner
par	PRP	par
forfait	NOM	forfait
(	PUN	(
teddy	NOM	teddy
decuf	NOM	decuf
,	PUN	,
salim	NOM	salim
yotla	ADJ	yotla
,	PUN	,
jimmy	NOM	jimmy
viol	NOM	viol
,	PUN	,
malick	NOM	malick
yotla	ADJ	yotla
,	PUN	,
kevin	NOM	kevin
adolphe	NAM	Adolphe
),	NOM	),
les	DET:ART	le
cinq	NUM	cinq
autres	ADJ	autre
(	PUN	(
reda	VER:simp	reda
saa	NOM	saa
,	PUN	,
angelo	NOM	angelo
viol	NOM	viol
,	PUN	,
farrgad	NOM	farrgad
saa	NOM	saa
,	PUN	,
julien	ADJ	julien
choffard	NOM	choffard
,	PUN	,
kevin	ADJ	kevin
bailly	NOM	bailly
)	PUN	)
dominant	VER:ppre	dominer
leurs	DET:POS	leur
adversaires	NOM	adversaire
respectifs	ADJ	respectif
aux	PRP:det	au
points	NOM	point
.	SENT	.
