carnet	NOM	carnet
bleu	ADJ	bleu
:	PUN	:
la	DET:ART	le
famille	NOM	famille
robin	ADJ	robin
s'	PRO:PER	se
agrandit	VER:pres	agrandir
.	SENT	.
depuis	PRP	depuis
jeudi	NOM	jeudi
,	PUN	,
milan	NOM	milan
a	VER:pres	avoir
un	DET:ART	un
petit	ADJ	petit
frère	NOM	frère
prénommé	VER:pper	prénommer
timéo	NOM	timéo
.	SENT	.
une	DET:ART	un
future	ADJ	futur
recrue	NOM	recrue
pour	PRP	pour
le	DET:ART	le
fc	ADJ	fc
eloyes	NOM	eloyes
.	SENT	.
toutes	PRO:IND	tout
nos	DET:POS	notre
félicitations	NOM	félicitation
à	PRP	à
fabrice	NOM	fabrice
et	KON	et
à	PRP	à
son	DET:POS	son
épouse	NOM	épouse
monia	NOM	monia
.	SENT	.
