le	DET:ART	le
foyer	NOM	foyer
rural	ADJ	rural
organise	VER:pres	organiser
une	DET:ART	un
sortie	NOM	sortie
au	PRP:det	au
salon	NOM	salon
de	PRP	de
l'	DET:ART	le
agriculture	NOM	agriculture
samedi	NOM	samedi
1	NUM	@card@
e	NOM	e
r	VER:subi	r
mars	NOM	mars
.	SENT	.
transport	NOM	transport
:	PUN	:
22	NUM	@card@
euros	NOM	euro
.	SENT	.
réservation	NOM	réservation
:	PUN	:
m.	ABR	m.
christophe	NOM	christophe
bourot	ADJ	bourot
,	PUN	,
au	PRP:det	au
03.83	NUM	@card@
.	SENT	.
52.37	NUM	@card@
.	SENT	.
88	NUM	@card@
