les	DET:ART	le
écoliers	ADJ	écolier
chalezeulois	NOM	chalezeulois
ont	VER:pres	avoir
quitté	VER:pper	quitter
les	DET:ART	le
locaux	NOM	local
du	PRP:det	du
centre	NOM	centre
julienne-javel	ADJ	julienne-javel
où	PRO:REL	où
ils	PRO:PER	il
mangeaient	VER:impf	manger
jusqu'aux	NOM	jusqu'aux
vacances	NOM	vacance
de	PRP	de
noël	NOM	noël
.	SENT	.
cette	PRO:DEM	ce
fois	NOM	foi|fois
,	PUN	,
ils	PRO:PER	il
iront	VER:futu	aller
déjeuner	VER:infi	déjeuner
dans	PRP	dans
la	DET:ART	le
nouvelle	ADJ	nouveau
cantine	NOM	cantine
récemment	ADV	récemment
construite	VER:pper	construire
dans	PRP	dans
l'	DET:ART	le
enceinte	NOM	enceinte
de	PRP	de
l'	DET:ART	le
école	NOM	école
.	SENT	.
au	PRP:det	au
cours	NOM	cour|cours
du	PRP:det	du
dernier	ADJ	dernier
repas	NOM	repas
dans	PRP	dans
les	DET:ART	le
anciens	NOM	ancien
locaux	ADJ	local
,	PUN	,
les	DET:ART	le
enfants	NOM	enfant
se	PRO:PER	se
sont	VER:pres	être
prêtés	VER:pper	prêter
de	PRP	de
bonne	ADJ	bon
grâce	NOM	grâce
à	PRP	à
une	DET:ART	un
sympathique	ADJ	sympathique
photo	NOM	photo
de	PRP	de
famille	NOM	famille
qui	PRO:REL	qui
ponctuait	VER:impf	ponctuer
12	NUM	@card@
années	NOM	année
d'	PRP	de
utilisation	NOM	utilisation
.	SENT	.
les	DET:ART	le
repas	NOM	repas
seront	VER:futu	être
toujours	ADV	toujours
préparés	VER:pper	préparer
par	PRP	par
l'	DET:ART	le
association	NOM	association
j.	ABR	j.
-	PUN	-
javel	NOM	javel
.	SENT	.
