le	DET:ART	le
miroir	NOM	miroir
de	PRP	de
sécurité	NOM	sécurité
,	PUN	,
à	PRP	à
l'	DET:ART	le
intersection	NOM	intersection
des	PRP:det	du
routes	NOM	route
de	PRP	de
monthureux	NOM	monthureux
et	KON	et
de	PRP	de
corre	NOM	corre
est	VER:pres	être
régulièrement	ADV	régulièrement
déréglé	VER:pper	dérégler
.	SENT	.
si	KON	si
ces	PRO:DEM	ce
troubles	NOM	trouble
persistent	VER:pres	persister
,	PUN	,
une	DET:ART	un
plainte	NOM	plainte
sera	VER:futu	être
déposée	VER:pper	déposer
en	PRP	en
gendarmerie	NOM	gendarmerie
par	PRP	par
la	DET:ART	le
mairie	NOM	mairie
.	SENT	.
