une	DET:ART	un
voiture	NOM	voiture
a	VER:pres	avoir
été	VER:pper	être
accidentée	VER:pper	accidenter
,	PUN	,
mercredi	NOM	mercredi
peu	ADV	peu
avant	PRP	avant
minuit	NOM	minuit
,	PUN	,
avenue	NOM	avenue
du	PRP:det	du
maréchal	NOM	maréchal
foch	NOM	foch
à	PRP	à
belfort	NOM	belfort
.	SENT	.
il	PRO:PER	il
n'	ADV	ne
y	PRO:PER	y
a	VER:pres	avoir
eu	VER:pper	avoir
que	KON	que
des	PRP:det	du
dégâts	NOM	dégât
matériels	ADJ	matériel
.	SENT	.
les	DET:ART	le
pompiers	NOM	pompier
de	PRP	de
belfort	NOM	belfort
nord	ADJ	nord
ont	VER:pres	avoir
procédé	VER:pper	procéder
au	PRP:det	au
nettoyage	NOM	nettoyage
de	PRP	de
la	DET:ART	le
chaussée	NOM	chaussée
.	SENT	.
