l'	DET:ART	le
amicale	ADJ	amical
«	PUN:cit	«
le	DET:ART	le
couarail	NOM	couarail
»	PUN:cit	»
organise	VER:pres	organiser
un	DET:ART	un
concours	NOM	concours
de	PRP	de
belote	NOM	belote
samedi	NOM	samedi
22	NUM	@card@
février	NOM	février
,	PUN	,
à	PRP	à
20	NUM	@card@
h	ABR	heure
,	PUN	,
à	PRP	à
la	DET:ART	le
salle	NOM	salle
du	PRP:det	du
pressoir	NOM	pressoir
.	SENT	.
nombreux	ADJ	nombreux
lots	NOM	lot
-	PUN	-
concours	NOM	concours
en	PRP	en
équipes	NOM	équipe
-	PUN	-
tarif	NOM	tarif
inscription	NOM	inscription
:	PUN	:
8	NUM	@card@
euros	NOM	euro
par	PRP	par
personne	NOM	personne
.	SENT	.
