hier	ADV	hier
,	PUN	,
peu	ADV	peu
après	PRP	après
9	NUM	@card@
h	ABR	heure
30	NUM	@card@
les	DET:ART	le
pompiers	NOM	pompier
se	PRO:PER	se
sont	VER:pres	être
rendus	VER:pper	rendre
49	NUM	@card@
rue	NOM	rue
sous-la-côte	VER:pres	sous-la-côte
à	PRP	à
mandeure	NOM	mandeure
pour	PRP	pour
maîtriser	VER:infi	maîtriser
un	DET:ART	un
feu	NOM	feu
de	PRP	de
cheminée	NOM	cheminée
qui	PRO:REL	qui
s'	PRO:PER	se
était	VER:impf	être
déclaré	VER:pper	déclarer
dans	PRP	dans
une	DET:ART	un
habitation	NOM	habitation
.	SENT	.
a	VER:pres	avoir
leur	DET:POS	leur
arrivée	NOM	arrivé|arrivée
,	PUN	,
les	DET:ART	le
soldats	NOM	soldat
du	PRP:det	du
feu	NOM	feu
n'	ADV	ne
ont	VER:pres	avoir
pas	ADV	pas
eu	VER:pper	avoir
à	PRP	à
intervenir	VER:infi	intervenir
...	PUN	...
le	DET:ART	le
sinistre	NOM	sinistre
avait	VER:impf	avoir
été	VER:pper	être
éteint	VER:pper	éteindre
par	PRP	par
les	DET:ART	le
propriétaires	NOM	propriétaire
de	PRP	de
la	DET:ART	le
maison	NOM	maison
.	SENT	.
