jean-claude	NOM	jean-claude
charton	NOM	charton
,	PUN	,
fleuriste	ADJ	fleuriste
,	PUN	,
organise	VER:pres	organiser
ce	PRO:DEM	ce
soir	NOM	soir
,	PUN	,
dans	PRP	dans
ses	DET:POS	son
serres	NOM	serre|serres
,	PUN	,
de	PRP	de
17	NUM	@card@
h	ABR	heure
à	PRP	à
19	NUM	@card@
h	ABR	heure
,	PUN	,
un	DET:ART	un
stage	NOM	stage
floral	ADJ	floral
sur	PRP	sur
le	DET:ART	le
thème	NOM	thème
de	PRP	de
la	DET:ART	le
saint-valentin	NOM	saint-valentin
.	SENT	.
