on	PRO:PER	on
a	VER:pres	avoir
tiré	VER:pper	tirer
les	DET:ART	le
rois	NOM	roi
à	PRP	à
la	DET:ART	le
maternelle	ADJ	maternel
centre	NOM	centre
et	KON	et
ce	PRO:DEM	ce
sont	VER:pres	être
de	PRP	de
biens	NOM	bien
jolis	ADJ	joli
princes	NOM	prince
et	KON	et
princesses	NOM	princesse
qui	PRO:REL	qui
se	PRO:PER	se
sont	VER:pres	être
vus	VER:pper	voir
couronnés	VER:pper	couronner
.	SENT	.
visiblement	ADV	visiblement
tous	PRO:IND	tout
ont	VER:pres	avoir
été	VER:pper	être
sacrés	ADJ	sacré
..	NOM	..
