réveil	NOM	réveil
vivifiant	VER:ppre	vivifier
pour	PRP	pour
cette	PRO:DEM	ce
résidante	ADJ	résidant
de	PRP	de
la	DET:ART	le
rue	NOM	rue
kennedy	NOM	kennedy
qui	PRO:REL	qui
,	PUN	,
dès	PRP	dès
potron	NOM	potron
minet	NOM	minet
,	PUN	,
a	VER:pres	avoir
«	PUN:cit	«
pris	VER:pper	prendre
la	DET:ART	le
porte	NOM	porte
»	PUN:cit	»
pour	PRP	pour
manier	VER:infi	manier
avec	PRP	avec
énergie	NOM	énergie
son	DET:POS	son
balai	NOM	balai
.	SENT	.
encore	ADV	encore
marquée	VER:pper	marquer
par	PRP	par
une	DET:ART	un
jambe	NOM	jambe
cassée	ADJ	cassé
,	PUN	,
elle	PRO:PER	elle
tente	VER:pres	tenter
de	PRP	de
prévenir	VER:infi	prévenir
les	DET:ART	le
éventuelles	ADJ	éventuel
chutes	NOM	chute
par	PRP	par
un	DET:ART	un
ménage	NOM	ménage
en	PRP	en
régle	NOM	régle
de	PRP	de
son	DET:POS	son
petit	ADJ	petit
bout	NOM	bout
de	PRP	de
trottoir	NOM	trottoir
.	SENT	.
ne	ADV	ne
dit-on	NOM	dit-on
pas	ADV	pas
qu'	KON	que
il	PRO:PER	il
vaut	VER:pres	valoir
mieux	ADV	mieux
balayer	VER:infi	balayer|balayer
devant	PRP	devant
sa	DET:POS	son
porte	NOM	porte
...	PUN	...
