la	DET:ART	le
belle	ADJ	beau
aventure	NOM	aventure
africaine	ADJ	africain
du	PRP:det	du
dakar	NOM	dakar
2003	NUM	@card@
a	VER:pres	avoir
finalement	ADV	finalement
pris	VER:pper	prendre
fin	NOM	fin
prématurément	ADV	prématurément
hier	ADV	hier
dans	PRP	dans
l'	DET:ART	le
épreuve	NOM	épreuve
chronométrée	VER:pper	chronométrer
de	PRP	de
sarir	NOM	sarir
-	PUN	-
siwa	VER:simp	siwa
pour	PRP	pour
l'	DET:ART	le
équipage	NOM	équipage
boroillot	ADJ	boroillot
bertin-hudelot	NOM	bertin-hudelot
(	PUN	(
mercedes	VER:pres	mercedes
).	VER:pper	).
les	DET:ART	le
doubiens	NOM	doubiens
alors	ADV	alors
bien	ADV	bien
placés	VER:pper	placer
au	PRP:det	au
classement	NOM	classement
provisoire	ADJ	provisoire
(	PUN	(
55	NUM	@card@
e)	NOM	e)
voyaient	VER:impf	voir
leur	DET:POS	leur
voyage	NOM	voyage
s'	PRO:PER	se
arrêter	VER:infi	arrêter
net	ADV	net
à	PRP	à
mi-chemin	ADV	mi-chemin
entre	PRP	entre
le	DET:ART	le
départ	NOM	départ
et	KON	et
l'	DET:ART	le
arrivée	NOM	arrivé|arrivée
de	PRP	de
cette	PRO:DEM	ce
11	NUM	@card@
e	NOM	e
étape	NOM	étape
.	SENT	.
selon	PRP	selon
la	DET:ART	le
direction	NOM	direction
de	PRP	de
course	NOM	course
:	PUN	:
«	PUN:cit	«
bertin	NOM	bertin
aurait	VER:cond	avoir
abdiqué	VER:pper	abdiquer
sur	PRP	sur
casse	NOM	casse
mécanique	ADJ	mécanique
...	PUN	...
».	VER:simp	».
peut-être	ADV	peut-être
en	PRP	en
saurons-nous	NOM	saurons-nous
davantage	ADV	davantage
prochainement	ADV	prochainement
.	SENT	.
