l'	DET:ART	le
espace	NOM	espace
culturel	ADJ	culturel
devient	VER:pres	devenir
,	PUN	,
chaque	PRO:IND	chaque
samedi	NOM	samedi
,	PUN	,
le	DET:ART	le
temple	NOM	temple
de	PRP	de
la	DET:ART	le
danse	NOM	danse
moderne	ADJ	moderne
,	PUN	,
grâce	NOM	grâce
aux	PRP:det	au
adeptes	NOM	adepte
de	PRP	de
cette	PRO:DEM	ce
discipline	NOM	discipline
très	ADV	très
agréable	ADJ	agréable
enseignée	VER:pper	enseigner
par	PRP	par
nathalie	NOM	nathalie
ganaye	NOM	ganaye
,	PUN	,
céline	ADJ	céline
malherbes	NOM	malherbe
et	KON	et
cathy	NOM	cathy
genoudet	NOM	genoudet
.	SENT	.
dans	PRP	dans
l'	DET:ART	le
après-midi	NOM	après-midi
,	PUN	,
ce	PRO:DEM	ce
sont	VER:pres	être
environ	PRP	environ
100	NUM	@card@
danseurs	NOM	danseur
qui	PRO:REL	qui
sont	VER:pres	être
venus	VER:pper	venir
apprendre	VER:infi	apprendre
.	SENT	.
baccarat	NOM	baccarat
dynamic	NOM	dynamic
présentera	VER:futu	présenter
un	DET:ART	un
spectacle	NOM	spectacle
à	PRP	à
bertrichamps	NOM	bertrichamps
le	DET:ART	le
samedi	NOM	samedi
29	NUM	@card@
mars	NOM	mars
et	KON	et
c'	PRO:DEM	ce
est	VER:pres	être
une	DET:ART	un
raison	NOM	raison
suffisante	ADJ	suffisant
pour	KON	pour
que	KON	que
tous	PRO:IND	tout
répètent	VER:pres	répéter
avec	PRP	avec
sérieux	NOM	sérieux
.	SENT	.
