champion	NOM	champion
de	PRP	de
district	NOM	district
à	PRP	à
la	DET:ART	le
libre	ADJ	libre
de	PRP	de
départementale	ADJ	départemental
1	NUM	@card@
en	PRP	en
2001	NUM	@card@
le	DET:ART	le
commercien	ADJ	commercien
jérémy	NOM	jérémy
guerreiro	NOM	guerreiro
,	PUN	,
promu	VER:pper	promouvoir
en	PRP	en
régionale	ADJ	régional
2	NUM	@card@
s'	PRO:PER	se
affirme	VER:pres	affirmer
déjà	ADV	déjà
comme	KON	comme
prétendant	VER:ppre	prétendre
au	PRP:det	au
titre	NOM	titre
2003	NUM	@card@
après	PRP	après
sa	DET:POS	son
belle	ADJ	beau
performance	NOM	performance
réalisée	VER:pper	réaliser
dimanche	NOM	dimanche
à	PRP	à
commercy	NOM	commercy
,	PUN	,
où	PRO:REL	où
il	PRO:PER	il
a	VER:pres	avoir
remporté	VER:pper	remporter
une	DET:ART	un
très	ADV	très
belle	ADJ	beau
victoire	NOM	victoire
sur	PRP	sur
laurent	VER:pres	laurer
bardot	NOM	bardot
(	PUN	(
bc	NOM	bc
verdun	ADJ	verdun
),	VER:simp	),
classé	VER:pper	classer
second	NOM	second
et	KON	et
robert	NOM	robert
maginot	NOM	maginot
(	PUN	(
bc	NOM	bc
vaucouleurs	NOM	vaucouleurs
).	ADJ	).
