les	DET:ART	le
pompiers	NOM	pompier
de	PRP	de
baume-les-dames	NOM	baume-les-dames
sont	VER:pres	être
intervenus	VER:pper	intervenir
rue	NOM	rue
du	PRP:det	du
chasnot	NOM	chasnot
chez	PRP	chez
m.	ABR	m.
serge	NOM	serge
loichot	ADJ	loichot
suite	NOM	suite
à	PRP	à
un	DET:ART	un
feu	NOM	feu
de	PRP	de
cheminée	NOM	cheminée
qui	PRO:REL	qui
a	VER:pres	avoir
été	VER:pper	être
rapidement	ADV	rapidement
maîtrisé	VER:pper	maîtriser
.	SENT	.
les	DET:ART	le
dégâts	NOM	dégât
sont	VER:pres	être
minimes	ADJ	minime
.	SENT	.
