l'	DET:ART	le
équipe	NOM	équipe
de	PRP	de
pétanque	NOM	pétanque
baccarat	NOM	baccarat
a	VER:pres	avoir
se	PRO:PER	se
déplacera	VER:futu	déplacer
le	DET:ART	le
dimanche	NOM	dimanche
2	NUM	@card@
février	NOM	février
et	KON	et
rencontrera	VER:futu	rencontrer
celle	PRO:DEM	celui
de	PRP	de
«	PUN:cit	«
vallée	NOM	vallée
du	PRP:det	du
rabodeau	NOM	rabodeau
a	VER:pres	avoir
»,	NOM	»,
en	PRP	en
excellence	NOM	excellence
b.	VER:subi	b.
départ	NOM	départ
13	NUM	@card@
h	ABR	heure
30	NUM	@card@
aux	PRP:det	au
arcades	NOM	arcade
.	SENT	.
