l'	DET:ART	le
association	NOM	association
efa	VER:simp	efa
(	PUN	(
enfance	NOM	enfance
et	KON	et
familles	NOM	famille
d'	PRP	de
adoption	NOM	adoption
)	PUN	)
organise	VER:pres	organiser
une	DET:ART	un
réunion	NOM	réunion
destinée	VER:pper	destiner
aux	PRP:det	au
personnes	NOM	personne
désireuses	ADJ	désireux
d'	PRP	de
adopter	VER:infi	adopter
un	DET:ART	un
enfant	NOM	enfant
.	SENT	.
elle	PRO:PER	elle
aura	VER:futu	avoir
lieu	NOM	lieu
vendredi	NOM	vendredi
28	NUM	@card@
mars	NOM	mars
,	PUN	,
à	PRP	à
20	NUM	@card@
h	ABR	heure
,	PUN	,
à	PRP	à
la	DET:ART	le
mairie	NOM	mairie
de	PRP	de
doubs	NOM	doubs
.	SENT	.
renseignements	NOM	renseignement
:	PUN	:
tél	ABR	téléphone
.	SENT	.
03.81	NUM	@card@
.	SENT	.
53.28	NUM	@card@
.	SENT	.
98	NUM	@card@
ou	KON	ou
03.81	NUM	@card@
.	SENT	.
85.02	NUM	@card@
.	SENT	.
16	NUM	@card@
