deux	NUM	deux
véhicules	NOM	véhicule
se	PRO:PER	se
sont	VER:pres	être
percutés	VER:pper	percuter
lundi	NOM	lundi
dans	PRP	dans
le	DET:ART	le
quartier	NOM	quartier
de	PRP	de
sous-roches	NOM	sous-roches
.	SENT	.
un	DET:ART	un
blessé	NOM	blessé
léger	ADJ	léger
,	PUN	,
âgé	ADJ	âgé
de	PRP	de
55	NUM	@card@
ans	NOM	an
,	PUN	,
a	VER:pres	avoir
été	VER:pper	être
transporté	VER:pper	transporter
au	PRP:det	au
centre	NOM	centre
hospitalier	ADJ	hospitalier
pour	PRP	pour
une	DET:ART	un
visite	NOM	visite
de	PRP	de
contrôle	NOM	contrôle
.	SENT	.
