contesté	VER:pper	contester
il	PRO:PER	il
y	PRO:PER	y
a	VER:pres	avoir
encore	ADV	encore
peu	ADV	peu
,	PUN	,
bruno	NOM	bruno
warnet	NOM	warnet
,	PUN	,
avec	PRP	avec
le	DET:ART	le
soutien	NOM	soutien
de	PRP	de
son	DET:POS	son
prédécesseur	NOM	prédécesseur
,	PUN	,
a	VER:pres	avoir
été	VER:pper	être
reconduit	VER:pper	reconduire
dans	PRP	dans
ses	DET:POS	son
fonctions	NOM	fonction
de	PRP	de
président	NOM	président
.	SENT	.
le	DET:ART	le
bureau	NOM	bureau
est	VER:pres	être
composé	VER:pper	composer
:	PUN	:
vice-présidents	NOM	vice-président
,	PUN	,
elie	ADJ	elie
reine	NOM	reine
et	KON	et
catherine	NOM	catherine
roger	VER:infi	roger
;	PUN	;
secrétaire	NOM	secrétaire
,	PUN	,
colette	NOM	colette
edime	NOM	edime
;	PUN	;
secrétaire-adjointe	VER:pper	secrétaire-adjointe
,	PUN	,
mireille	NOM	mireille
tpia	NOM	tpia
;	PUN	;
trésorier	NOM	trésorier
,	PUN	,
jérôme	NOM	jérôme
feutry	ADJ	feutry
;	PUN	;
trésorier-adjoint	NOM	trésorier-adjoint
,	PUN	,
gérard	NOM	gérard
morisset	ADJ	morisset
.	SENT	.
membres	NOM	membre
:	PUN	:
fabrice	ADJ	fabrice
aury	NOM	aury
,	PUN	,
franck	NOM	franck
bastien	ADJ	bastien
,	PUN	,
romain	ADJ	romain
bouvier	NOM	bouvier
,	PUN	,
madeleine	NOM	madeleine
chicault	ADJ	chicault
,	PUN	,
philippe	ADJ	philippe
colin	NOM	colin
,	PUN	,
jacques	NOM	jacque|jacques
goujaud	NOM	goujaud
,	PUN	,
eric	ADJ	eric
guéry	NOM	guéry
,	PUN	,
fatima	VER:simp	fatima
huguenin	NOM	huguenin
,	PUN	,
frédéric	NOM	frédéric
humblot	ADJ	humblot
,	PUN	,
jacqueline	NOM	jacqueline
lupone	ADJ	lupone
,	PUN	,
jean-françois	NOM	jean-françois
pernot	ADJ	pernot
et	KON	et
jeannine	NOM	jeannine
petre	ADJ	petre
.	SENT	.
