dorian	NOM	dorian
est	VER:pres	être
heureux	ADJ	heureux
d'	PRP	de
annoncer	VER:infi	annoncer
la	DET:ART	le
naissance	NOM	naissance
de	PRP	de
sa	DET:POS	son
s	NOM	s
	ADJ	
ur	VER:simp	ur
margot	NOM	margot
,	PUN	,
qui	PRO:REL	qui
a	VER:pres	avoir
poussé	VER:pper	pousser
ses	DET:POS	son
premiers	NUM	premier
cris	NOM	cri
,	PUN	,
le	DET:ART	le
31	NUM	@card@
décembre	NOM	décembre
,	PUN	,
à	PRP	à
remiremont	VER:futu	remiremont
.	SENT	.
elle	PRO:PER	elle
vient	VER:pres	venir
agrandir	VER:infi	agrandir
le	DET:ART	le
foyer	NOM	foyer
d'	PRP	de
aurélia	NOM	aurélia
ferry	NOM	ferry
et	KON	et
de	PRP	de
cédric	NOM	cédric
hiniger	ADJ	hiniger
,	PUN	,
domiciliés	VER:pper	domicilier
13	NUM	@card@
grand'rue	NOM	grand'rue
.	SENT	.
meilleurs	ADJ	meilleur
v	NOM	v
	ADJ	
ux	ADJ	ux
au	PRP:det	au
bébé	NOM	bébé
et	KON	et
félicitations	NOM	félicitation
aux	PRP:det	au
parents	NOM	parent|parents
.	SENT	.
