samedi	NOM	samedi
après-midi	NOM	après-midi
à	PRP	à
l'	DET:ART	le
hôtel	NOM	hôtel
de	PRP	de
ville	NOM	ville
,	PUN	,
l'	DET:ART	le
adjointe	NOM	adjoint
au	PRP:det	au
maire	NOM	maire
claudine	VER:subp	claudine
marchesi	VER:pper	marchesi
a	VER:pres	avoir
uni	VER:pper	unir
par	PRP	par
les	DET:ART	le
liens	NOM	lien
du	PRP:det	du
mariage	NOM	mariage
hicham	NOM	hicham
el	VER:subi	el
mardhi	NOM	mardhi
,	PUN	,
intérimaire	ADJ	intérimaire
,	PUN	,
domicilié	VER:pper	domicilier
rue	NOM	rue
frédéric-jacquet	NOM	frédéric-jacquet
à	PRP	à
sochaux	NOM	sochaux
,	PUN	,
et	KON	et
nahida	NOM	nahida
mahroug	NOM	mahroug
,	PUN	,
domiciliée	VER:pper	domicilier
à	PRP	à
noisy-le-sec	NOM	noisy-le-sec
(	PUN	(
seine-saint-denis	VER:pres	seine-saint-denis
).	VER:pper	).
tous	PRO:IND	tout
nos	DET:POS	notre
v	NOM	v
	ADJ	
ux	ADJ	ux
.	SENT	.
