la	DET:ART	le
prochaine	ADJ	prochain
réunion	NOM	réunion
du	PRP:det	du
conseil	NOM	conseil
municipal	ADJ	municipal
se	PRO:PER	se
tiendra	VER:futu	tenir
lundi	NOM	lundi
10	NUM	@card@
février	NOM	février
,	PUN	,
à	PRP	à
20	NUM	@card@
h	ABR	heure
30	NUM	@card@
en	PRP	en
mairie	NOM	mairie
;	PUN	;
a	VER:pres	avoir
l'	DET:ART	le
ordre	NOM	ordre
du	PRP:det	du
jour	NOM	jour
:	PUN	:
projet	NOM	projet
lotissement	NOM	lotissement
et	KON	et
questions	NOM	question
diverses	ADJ	divers
.	SENT	.
