conséquence	NOM	conséquence
du	PRP:det	du
vent	NOM	vent
violent	ADJ	violent
qui	PRO:REL	qui
a	VER:pres	avoir
soufflé	VER:pper	souffler
sur	PRP	sur
le	DET:ART	le
secteur	NOM	secteur
durant	PRP	durant
deux	NUM	deux
jours	NOM	jour
:	PUN	:
une	DET:ART	un
cheminée	NOM	cheminée
est	VER:pres	être
tombée	VER:pper	tomber
sur	PRP	sur
le	DET:ART	le
toit	NOM	toit
d'	PRP	de
une	DET:ART	un
habitation	NOM	habitation
hier	ADV	hier
après-midi	NOM	après-midi
.	SENT	.
les	DET:ART	le
pompiers	NOM	pompier
de	PRP	de
luxeuil	NOM	luxeuil
sont	VER:pres	être
intervenus	VER:pper	intervenir
pour	PRP	pour
l'	PRO:PER	la|le
enlever	VER:infi	enlever
.	SENT	.
