l'	DET:ART	le
association	NOM	association
franc-comtoise	ADJ	franc-comtois
des	PRP:det	du
anciens	ADJ	ancien
combattants	ADJ	combattant
section	NOM	section
du	PRP:det	du
canton	NOM	canton
d'	PRP	de
audeux	NOM	audeux
tient	VER:pres	tenir
à	PRP	à
préciser	VER:infi	préciser
qu'	KON	que
elle	PRO:PER	elle
tiendra	VER:futu	tenir
son	DET:POS	son
assemblée	NOM	assemblée
générale	ADJ	général
annuelle	ADJ	annuel
à	PRP	à
sauvagney	NOM	sauvagney
le	DET:ART	le
27	NUM	@card@
avril	NOM	avril
2003	NUM	@card@
en	PRP	en
présence	NOM	présence
du	PRP:det	du
président	NOM	président
du	PRP:det	du
conseil	NOM	conseil
général	ADJ	général
,	PUN	,
du	PRP:det	du
maire	NOM	maire
.	SENT	.
elle	PRO:PER	elle
rappelle	VER:pres	rappeler
à	PRP	à
cette	PRO:DEM	ce
occasion	NOM	occasion
qu'	PRO:REL	que
elle	PRO:PER	elle
accueille	VER:pres	accueillir
tous	PRO:IND	tout
les	DET:ART	le
anciens	NOM	ancien
combattants	ADJ	combattant
quel	PRO:REL	quel
que	KON	que
soit	KON	soit
le	DET:ART	le
conflit	NOM	conflit
armé	ADJ	armé
auquel	PRO:REL	auquel
ils	PRO:PER	il
ont	VER:pres	avoir
participé	VER:pper	participer
.	SENT	.
