l'	DET:ART	le
association	NOM	association
maison	NOM	maison
du	PRP:det	du
quartier	NOM	quartier
jean-jaurès	ADJ	jean-jaurès
propose	VER:pres	proposer
un	DET:ART	un
après-midi	NOM	après-midi
de	PRP	de
danse	NOM	danse
et	KON	et
de	PRP	de
jeux	NOM	jeu
dimanche	NOM	dimanche
à	PRP	à
15	NUM	@card@
h.	ABR	h.
inscriptions	NOM	inscription
avant	PRP	avant
le	DET:ART	le
15	NUM	@card@
janvier	NOM	janvier
,	PUN	,
18	NUM	@card@
h	ABR	heure
,	PUN	,
dernier	ADJ	dernier
délai	NOM	délai
.	SENT	.
