suite	NOM	suite
aux	PRP:det	au
mauvaises	ADJ	mauvais
conditions	NOM	condition
climatiques	ADJ	climatique
actuelles	ADJ	actuel
,	PUN	,
les	DET:ART	le
rencontres	NOM	rencontre
seniors	NOM	senior
,	PUN	,
jeunes	ADJ	jeune
et	KON	et
vétérans	NOM	vétéran
,	PUN	,
gestion	NOM	gestion
district	NOM	district
,	PUN	,
prévues	VER:pper	prévoir
les	DET:ART	le
8	NUM	@card@
et	KON	et
9	NUM	@card@
février	NOM	février
sont	VER:pres	être
reportées	VER:pper	reporter
à	PRP	à
une	DET:ART	un
date	NOM	date
ultérieure	ADJ	ultérieur
.	SENT	.
