l'	DET:ART	le
équipe	NOM	équipe
fanion	NOM	fanion
du	PRP:det	du
tcl	NOM	tcl
qui	PRO:REL	qui
opère	VER:pres	opérer
en	PRP	en
promotion	NOM	promotion
d'	PRP	de
honneur	NOM	honneur
disputera	VER:futu	disputer
son	DET:POS	son
deuxième	NUM	deuxième
match	NOM	match
de	PRP	de
championnat	NOM	championnat
dimanche	NOM	dimanche
contre	PRP	contre
champigneulles	NOM	champigneulles
.	SENT	.
sous	PRP	sous
le	DET:ART	le
couvert	NOM	couvert
de	PRP	de
fenal	NOM	fenal
,	PUN	,
c'	PRO:DEM	ce
est	VER:pres	être
une	DET:ART	un
bonne	ADJ	bon
occasion	NOM	occasion
pour	PRP	pour
claudil	NOM	claudil
,	PUN	,
pierson	NOM	pierson
et	KON	et
leurs	DET:POS	leur
amis	NOM	ami
de	PRP	de
signer	VER:infi	signer
une	DET:ART	un
seconde	NUM	second
victoire	NOM	victoire
après	PRP	après
celle	PRO:DEM	celui
qui	PRO:REL	qui
a	VER:pres	avoir
été	VER:pper	être
obtenue	VER:pper	obtenir
contre	PRP	contre
l'	DET:ART	le
asptt	ADJ	asptt
nancy	NOM	nancy
.	SENT	.
