mercredi	NOM	mercredi
,	PUN	,
en	PRP	en
mairie	NOM	mairie
d'	PRP	de
etupes	NOM	etupes
,	PUN	,
anna	VER:simp	anna
cafarelli	VER:pper	cafarelli
,	PUN	,
adjointe	VER:pper	adjoindre
,	PUN	,
a	VER:pres	avoir
reçu	VER:pper	recevoir
les	DET:ART	le
consentements	NOM	consentement
de	PRP	de
dragan	NOM	dragan
djusic	NOM	djusic
,	PUN	,
mécanicien	ADJ	mécanicien
,	PUN	,
et	KON	et
d'	PRP	de
ivana	NOM	ivana
pantic	NOM	pantic
.	SENT	.
les	DET:ART	le
nouveaux	ADJ	nouveau
époux	NOM	époux
résident	VER:pres	résider
avenue	NOM	avenue
du	PRP:det	du
général	NOM	général
de	PRP	de
gaulle	NOM	gaulle
.	SENT	.
nos	DET:POS	notre
félicitations	NOM	félicitation
.	SENT	.
