dimanche	NOM	dimanche
prochain	ADJ	prochain
,	PUN	,
pascal	ADJ	pascal
sevran	NOM	sevran
et	KON	et
son	DET:POS	son
orchestre	NOM	orchestre
animeront	VER:futu	animer
un	DET:ART	un
thé	NOM	thé
dansant	VER:ppre	danser
organisé	VER:pper	organiser
par	PRP	par
les	DET:ART	le
amis	NOM	ami
de	PRP	de
natalie	NOM	natalie
.	SENT	.
a	VER:pres	avoir
partir	VER:infi	partir
de	PRP	de
15	NUM	@card@
h	ABR	heure
30	NUM	@card@
à	PRP	à
la	DET:ART	le
salle	NOM	salle
valcourt	ADJ	valcourt
.	SENT	.
entrée	NOM	entrée
:	PUN	:
23	NUM	@card@
euros	NOM	euro
.	SENT	.
réservations	NOM	réservation
au	PRP:det	au
03.83	NUM	@card@
.	SENT	.
43.26	NUM	@card@
.	SENT	.
15	NUM	@card@
