hier	ADV	hier
vers	PRP	vers
8	NUM	@card@
h	ABR	heure
,	PUN	,
une	DET:ART	un
automobiliste	NOM	automobiliste
s'	PRO:PER	se
est	VER:pres	être
retrouvée	VER:pper	retrouver
dans	PRP	dans
le	DET:ART	le
fossé	NOM	fossé
à	PRP	à
hauteur	NOM	hauteur
de	PRP	de
la	DET:ART	le
base	NOM	base
intermarché	VER:pper	intermarché
,	PUN	,
alors	ADV	alors
qu'	KON	que
elle	PRO:PER	elle
circulait	VER:impf	circuler
sur	PRP	sur
la	DET:ART	le
rn	NOM	rn
59	NUM	@card@
entre	PRP	entre
nancy	NOM	nancy
et	KON	et
strasbourg	NOM	strasbourg
.	SENT	.
les	DET:ART	le
pompiers	NOM	pompier
de	PRP	de
saint-dié	NOM	saint-dié
sont	VER:pres	être
rapidement	ADV	rapidement
venus	VER:pper	venir
lui	PRO:PER	lui
porter	VER:infi	porter
secours	NOM	secours
.	SENT	.
seule	ADJ	seul
à	PRP	à
bord	NOM	bord
de	PRP	de
son	DET:POS	son
véhicule	NOM	véhicule
,	PUN	,
la	DET:ART	le
conductrice	NOM	conducteur
n'	ADV	ne
a	VER:pres	avoir
pas	ADV	pas
été	VER:pper	être
blessée	VER:pper	blesser
.	SENT	.
