la	DET:ART	le
levée	NOM	levée
des	PRP:det	du
barrières	NOM	barrière
de	PRP	de
dégel	NOM	dégel
est	VER:pres	être
annoncée	VER:pper	annoncer
pour	PRP	pour
aujourd'hui	ADV	aujourd'hui
à	PRP	à
8	NUM	@card@
h	ABR	heure
,	PUN	,
sur	PRP	sur
l'	DET:ART	le
ensemble	NOM	ensemble
du	PRP:det	du
réseau	NOM	réseau
routier	ADJ	routier
départemental	ADJ	départemental
.	SENT	.
les	DET:ART	le
routes	NOM	route
ont	VER:pres	avoir
retrouvé	VER:pper	retrouver
leur	DET:POS	leur
capacité	NOM	capacité
à	PRP	à
supporter	VER:infi	supporter
les	DET:ART	le
charges	NOM	charge
lourdes	ADJ	lourd
.	SENT	.
la	DET:ART	le
seule	ADJ	seul
restriction	NOM	restriction
reste	VER:pres	rester
les	DET:ART	le
transports	NOM	transport
exceptionnels	ADJ	exceptionnel
jusqu'à	NOM	jusqu'à
vendredi	NOM	vendredi
31	NUM	@card@
janvier	NOM	janvier
.	SENT	.
