le	DET:ART	le
moulin	NOM	moulin
de	PRP	de
pontcey	NOM	pontcey
radicalise	VER:pres	radicaliser
son	DET:POS	son
approche	NOM	approche
rock	NOM	rock
en	PRP	en
accueillant	ADJ	accueillant
samedi	NOM	samedi
,	PUN	,
à	PRP	à
partir	VER:infi	partir
de	PRP	de
21	NUM	@card@
h	ABR	heure
30	NUM	@card@
deux	NUM	deux
groupes	NOM	groupe
tendance	NOM	tendance
hardcore	NOM	hardcore
.	SENT	.
wachback	NOM	wachback
d'	PRP	de
abord	NOM	abord
,	PUN	,
originaire	ADJ	originaire
de	PRP	de
strasbourg	NOM	strasbourg
,	PUN	,
réputé	VER:pper	réputer
dans	PRP	dans
le	DET:ART	le
milieu	NOM	milieu
,	PUN	,
et	KON	et
taf	NOM	taf
,	PUN	,
combo	NOM	combo
luron	NOM	luron
,	PUN	,
sélectionné	VER:pper	sélectionner
au	PRP:det	au
tremplin	NOM	tremplin
des	PRP:det	du
eurockéennes	NOM	eurockéennes
.	SENT	.
