samedi	NOM	samedi
soir	NOM	soir
,	PUN	,
ves	VER:pper	ves
20	NUM	@card@
h	ABR	heure
,	PUN	,
une	DET:ART	un
vl	NOM	vl
a	VER:pres	avoir
été	VER:pper	être
détruite	VER:pper	détruire
par	PRP	par
les	DET:ART	le
flammes	NOM	flamme
,	PUN	,
dans	PRP	dans
la	DET:ART	le
rue	NOM	rue
georges-bizet	ADJ	georges-bizet
.	SENT	.
les	DET:ART	le
sapeurs-pompiers	NOM	sapeurs-pompiers
ont	VER:pres	avoir
éteint	VER:pper	éteindre
le	DET:ART	le
sinistre	NOM	sinistre
au	PRP:det	au
moyen	NOM	moyen
d'	PRP	de
une	DET:ART	un
petite	ADJ	petit
lance	NOM	lance
.	SENT	.
