partis	VER:pper	partir
peu	ADV	peu
après	PRP	après
midi	NOM	midi
de	PRP	de
la	DET:ART	le
région	NOM	région
raonnaise	ADJ	raonnaise
,	PUN	,
les	DET:ART	le
bus	NOM	bus
affrétés	VER:pper	affréter
et	KON	et
payés	VER:pper	payer|payer
par	PRP	par
des	PRP:det	du
sponsors	NOM	sponsor
du	PRP:det	du
clubs	NOM	club
arrivent	VER:pres	arriver
au	PRP:det	au
stade	NOM	stade
vers	PRP	vers
14	NUM	@card@
h	ABR	heure
30	NUM	@card@
chacun	PRO:IND	chacun
a	VER:pres	avoir
rivalisé	VER:pper	rivaliser
d'	PRP	de
imagination	NOM	imagination
pour	PRP	pour
s'	PRO:PER	se
identifier	VER:infi	identifier
à	PRP	à
l'	DET:ART	le
usr	NOM	usr
.	SENT	.
près	ADV	près
de	PRP	de
400	NUM	@card@
fidèles	NOM	fidèle
de	PRP	de
raon	NOM	raon
s'	PRO:PER	se
installeront	VER:futu	installer
dans	PRP	dans
la	DET:ART	le
tribune	NOM	tribune
.	SENT	.
