le	DET:ART	le
conseil	NOM	conseil
municipal	ADJ	municipal
se	PRO:PER	se
réunira	VER:futu	réunir
ce	PRO:DEM	ce
vendredi	NOM	vendredi
7	NUM	@card@
février	NOM	février
,	PUN	,
à	PRP	à
19	NUM	@card@
h	ABR	heure
,	PUN	,
salle	NOM	salle
de	PRP	de
la	DET:ART	le
mairie	NOM	mairie
.	SENT	.
a	VER:pres	avoir
l'	DET:ART	le
ordre	NOM	ordre
du	PRP:det	du
jour	NOM	jour
,	PUN	,
budgets	NOM	budget
,	PUN	,
taxe	NOM	taxe
professionnelle	ADJ	professionnel
,	PUN	,
frais	ADJ	frais
de	PRP	de
scolarité	NOM	scolarité
pour	PRP	pour
enfants	NOM	enfant
inscrits	VER:pper	inscrire
à	PRP	à
l'	DET:ART	le
extérieur	NOM	extérieur
,	PUN	,
location	NOM	location
d'	PRP	de
un	DET:ART	un
logement	NOM	logement
communal	ADJ	communal
,	PUN	,
questions	NOM	question
diverses	ADJ	divers
.	SENT	.
