un	DET:ART	un
tracteur	NOM	tracteur
voilà	ADV	voilà
une	DET:ART	un
façon	NOM	façon
originale	ADJ	original
pour	PRP	pour
faire	VER:infi	faire
ses	DET:POS	son
courses	NOM	course
au	PRP:det	au
supermarché	NOM	supermarché
.	SENT	.
jeudi	NOM	jeudi
dernier	ADJ	dernier
deux	NUM	deux
hommes	NOM	homme
se	PRO:PER	se
rendaient	VER:impf	rendre
ainsi	ADV	ainsi
au	PRP:det	au
centre	NOM	centre
commercial	ADJ	commercial
leclerc	NOM	leclerc
à	PRP	à
bord	NOM	bord
de	PRP	de
ce	PRO:DEM	ce
moyen	NOM	moyen
de	PRP	de
locomotion	NOM	locomotion
plutôt	ADV	plutôt
inhabituel	ADJ	inhabituel
qui	PRO:REL	qui
faisait	VER:impf	faire
figure	NOM	figure
d'	PRP	de
otni	NOM	otni
(	PUN	(
objet	NOM	objet
terrestre	ADJ	terrestre
non	ADV	non
identifié	VER:pper	identifier
)	PUN	)
aux	PRP:det	au
côtés	NOM	côté
des	PRP:det	du
véhicules	NOM	véhicule
particuliers	ADJ	particulier
.	SENT	.
est-ce	ADJ	est-ce
que	KON	que
la	DET:ART	le
folie	NOM	folie
soldes	NOM	solde
avaient	VER:impf	avoir
motivé	VER:pper	motiver
cette	PRO:DEM	ce
expédition	NOM	expédition
spontanée	ADJ	spontané
à	PRP	à
20	NUM	@card@
km/h	ABR	kilomètres-heure
sur	PRP	sur
la	DET:ART	le
route	NOM	route
de	PRP	de
nancy	NOM	nancy
.	SENT	.
rien	ADV	rien
,	PUN	,
n'	ADV	ne
est	VER:pres	être
moins	ADV	moins
sûr	ADJ	sûr
.	SENT	.
ces	PRO:DEM	ce
clients	NOM	client
particuliers	ADJ	particulier
n'	ADV	ne
ont	VER:pres	avoir
pas	ADV	pas
du	PRP:det	du
rapporter	VER:infi	rapporter
grand	ADJ	grand
chose	NOM	chose
de	PRP	de
leurs	DET:POS	leur
emplettes	NOM	emplette
étant	VER:ppre	être
donné	VER:pper	donner
l'	DET:ART	le
absence	NOM	absence
de	PRP	de
tout	PRO:IND	tout
coffre	NOM	coffre
.	SENT	.
