depuis	PRP	depuis
novembre	NOM	novembre
1992	NUM	@card@
390	NUM	@card@
enfants	NOM	enfant
différents	ADJ	différent
ont	VER:pres	avoir
été	VER:pper	être
accueillis	VER:pper	accueillir
à	PRP	à
la	DET:ART	le
crèche	NOM	crèche
halte-garderie	NOM	halte-garderie
;	PUN	;
24.000	NUM	@card@
repas	NOM	repas
,	PUN	,
25.000	NUM	@card@
goûters	NOM	goûter
,	PUN	,
10.500	NUM	@card@
biberons	NOM	biberon
ont	VER:pres	avoir
été	VER:pper	être
donnés	VER:pper	donner
;	PUN	;
210.000	NUM	@card@
couches	NOM	couche
ont	VER:pres	avoir
été	VER:pper	être
nécessaires	ADJ	nécessaire
et	KON	et
7.350	NUM	@card@
lessives	NOM	lessive
comptabilisées	VER:pper	comptabiliser
;	PUN	;
33	NUM	@card@
personnes	NOM	personne
ont	VER:pres	avoir
été	VER:pper	être
employés	VER:pper	employer
.	SENT	.
les	DET:ART	le
petites	ADJ	petit
clochettes	NOM	clochette
de	PRP	de
la	DET:ART	le
porte	NOM	porte
d'	PRP	de
entrée	NOM	entrée
ont	VER:pres	avoir
tinté	VER:pper	tinter
95.000	NUM	@card@
fois	NOM	foi|fois
.	SENT	.
