chez	PRP	chez
didier	NOM	didier
et	KON	et
florence	NOM	florence
brabant	NOM	brabant
,	PUN	,
alice	NOM	alice
,	PUN	,
deuxième	NUM	deuxième
enfant	NOM	enfant
du	PRP:det	du
couple	NOM	couple
,	PUN	,
est	VER:pres	être
venue	VER:pper	venir
agrandir	VER:infi	agrandir
le	DET:ART	le
cercle	NOM	cercle
familial	ADJ	familial
.	SENT	.
nos	DET:POS	notre
félicitations	NOM	félicitation
aux	PRP:det	au
parents	ADJ	parent
et	KON	et
meilleurs	ADJ	meilleur
v	NOM	v
	ADJ	
ux	ADJ	ux
de	PRP	de
bonheur	NOM	bonheur
à	PRP	à
alice	NOM	alice
.	SENT	.
