une	DET:ART	un
messe	NOM	messe
sera	VER:futu	être
célébrée	VER:pper	célébrer
dimanche	NOM	dimanche
9	NUM	@card@
février	NOM	février
,	PUN	,
à	PRP	à
9	NUM	@card@
h	ABR	heure
30	NUM	@card@
église	NOM	église
st-calixte	ADJ	st-calixte
.	SENT	.
le	DET:ART	le
conseil	NOM	conseil
municipal	ADJ	municipal
se	PRO:PER	se
réunira	VER:futu	réunir
lundi	NOM	lundi
10	NUM	@card@
février	NOM	février
,	PUN	,
à	PRP	à
18	NUM	@card@
h	ABR	heure
30	NUM	@card@
a	VER:pres	avoir
l'	DET:ART	le
ordre	NOM	ordre
du	PRP:det	du
jour	NOM	jour
:	PUN	:
branchements	NOM	branchement
d'	PRP	de
assainissement	NOM	assainissement
chez	PRP	chez
les	DET:ART	le
particuliers	NOM	particulier
;	PUN	;
circulation	NOM	circulation
sur	PRP	sur
la	DET:ART	le
rd	NOM	rd
180	NUM	@card@
;	PUN	;
aménagement	NOM	aménagement
parking	NOM	parking
trottoir	NOM	trottoir
route	NOM	route
de	PRP	de
longeville	NOM	longeville
;	PUN	;
affaires	NOM	affaire
diverses	ADJ	divers
.	SENT	.
