perick	NOM	perick
est	VER:pres	être
arrivé	VER:pper	arriver
au	PRP:det	au
foyer	NOM	foyer
poinsot	NOM	poinsot
,	PUN	,
4	NUM	@card@
rue	NOM	rue
du	PRP:det	du
moulin	NOM	moulin
.	SENT	.
sa	DET:POS	son
grande	ADJ	grand
s	NOM	s
	ADJ	
ur	VER:simp	ur
laurène	ADJ	laurène
l'	PRO:PER	la|le
y	PRO:PER	y
attendait	VER:impf	attendre
avec	PRP	avec
impatience	NOM	impatience
.	SENT	.
il	PRO:PER	il
est	VER:pres	être
né	VER:pper	naître
le	DET:ART	le
4	NUM	@card@
janvier	NOM	janvier
à	PRP	à
nancy	NOM	nancy
,	PUN	,
pèse	NOM	pèse
3,200	NUM	@card@
kg	ABR	kg
et	KON	et
mesure	NOM	mesure
47	NUM	@card@
cm	NOM	cm
.	SENT	.
bienvenue	VER:pper	bienvenir
au	PRP:det	au
premier	NUM	premier
bébé	NOM	bébé
de	PRP	de
l'	DET:ART	le
année	NOM	année
,	PUN	,
et	KON	et
félicitations	NOM	félicitation
aux	PRP:det	au
heureux	ADJ	heureux
parents	NOM	parent|parents
.	SENT	.
