epinal	NOM	epinal
.	SENT	.
_	NOM	_
plusieurs	PRO:IND	plusieurs
coureurs	NOM	coureur
de	PRP	de
la	DET:ART	le
vôge	ADJ	vôge
vtt	NOM	vtt
se	PRO:PER	se
sont	VER:pres	être
rendus	VER:pper	rendre
ce	PRO:DEM	ce
week-end	NOM	week-end
à	PRP	à
saint-gervais	NOM	saint-gervais
pour	PRP	pour
participer	VER:infi	participer
à	PRP	à
la	DET:ART	le
snow	NOM	snow
bike	NOM	bike
cup	NOM	cup
.	SENT	.
une	DET:ART	un
sortie	NOM	sortie
prometteuse	ADJ	prometteur
pour	PRP	pour
les	DET:ART	le
protégés	NOM	protégé
d'	PRP	de
eric	NOM	eric
jacoté	ADJ	jacoté
.	SENT	.
ainsi	ADV	ainsi
,	PUN	,
jérôme	NOM	jérôme
conreaux	ADJ	conreaux
et	KON	et
rémy	ADJ	rémy
absalon	NOM	absalon
ont	VER:pres	avoir
signé	VER:pper	signer
un	DET:ART	un
joli	ADJ	joli
doublé	NOM	doublé
tandis	KON	tandis
que	KON	que
estelle	NOM	estelle
vuillemin	ADJ	vuillemin
s'	PRO:PER	se
est	VER:pres	être
imposée	VER:pper	imposer
chez	PRP	chez
les	DET:ART	le
féminines	ADJ	féminin
(	PUN	(
27	NUM	@card@
e	NOM	e
au	PRP:det	au
scratch	NOM	scratch
).	ADJ	).
