dix	NUM	dix
,	PUN	,
c'	PRO:DEM	ce
est	VER:pres	être
le	DET:ART	le
nombre	NOM	nombre
de	PRP	de
matches	NOM	match
disputés	VER:pper	disputer
à	PRP	à
domicile	NOM	domicile
par	PRP	par
besançon	NOM	besançon
rc	NOM	rc
dix	NUM	dix
matches	NOM	match
sans	PRP	sans
défaite	NOM	défaite
pour	PRP	pour
les	DET:ART	le
footballeurs	NOM	footballeur
bisontins	ADJ	bisontin
au	PRP:det	au
stade	NOM	stade
léo-lagrange	ADJ	léo-lagrange
depuis	PRP	depuis
le	DET:ART	le
10	NUM	@card@
août	NOM	août
2002	NUM	@card@
avec	PRP	avec
sept	NUM	sept
victoires	NOM	victoire
pour	PRP	pour
trois	NUM	trois
nuls	ADJ	nul
,	PUN	,
les	DET:ART	le
hommes	NOM	homme
de	PRP	de
stéphane	ADJ	stéphane
paille	NOM	paille
savent	VER:pres	savoir
désormais	ADV	désormais
se	PRO:PER	se
faire	VER:infi	faire
respecter	VER:infi	respecter
dans	PRP	dans
leur	DET:POS	leur
fief	NOM	fief
.	SENT	.
