l'	DET:ART	le
ambassade	NOM	ambassade
des	PRP:det	du
etats-unis	NOM	etats-unis
à	PRP	à
tel-aviv	NOM	tel-aviv
a	VER:pres	avoir
annoncé	VER:pper	annoncer
hier	ADV	hier
qu'	KON	que
elle	PRO:PER	elle
allait	VER:impf	aller
évacuer	VER:infi	évacuer
cette	PRO:DEM	ce
semaine	NOM	semaine
une	DET:ART	un
partie	NOM	partie
de	PRP	de
son	DET:POS	son
personnel	NOM	personnel
,	PUN	,
renforçant	VER:ppre	renforcer
le	DET:ART	le
sentiment	NOM	sentiment
en	PRP	en
israël	NAM	Israël
qu'	KON	que
un	DET:ART	un
conflit	NOM	conflit
en	PRP	en
irak	NOM	irak
était	VER:impf	être
désormais	ADV	désormais
très	ADV	très
proche	ADJ	proche
.	SENT	.
cette	PRO:DEM	ce
impression	NOM	impression
a	VER:pres	avoir
également	ADV	également
été	VER:pper	être
confirmée	VER:pper	confirmer
par	PRP	par
le	DET:ART	le
fait	NOM	fait
que	KON	que
les	DET:ART	le
etats-unis	NOM	etats-unis
ont	VER:pres	avoir
décidé	VER:pper	décider
de	PRP	de
maintenir	VER:infi	maintenir
en	PRP	en
israël	NOM	israël
des	PRP:det	du
forces	NOM	force|forces
venues	VER:pper	venir
récemment	ADV	récemment
prendre	VER:infi	prendre
part	NOM	part
à	PRP	à
un	DET:ART	un
exercice	NOM	exercice
commun	ADJ	commun
israélo-américain	ADJ	israélo-américain
de	PRP	de
défense	NOM	défense
contre	PRP	contre
des	PRP:det	du
avions	NOM	avion
et	KON	et
des	PRP:det	du
missiles	NOM	missile
et	KON	et
qui	PRO:REL	qui
étaient	VER:impf	être
censées	ADJ	censé
repartir	VER:infi	repartir
une	DET:ART	un
fois	NOM	foi|fois
ces	PRO:DEM	ce
manoeuvres	NOM	manœuvre
terminées	VER:pper	terminer
.	SENT	.
le	DET:ART	le
porte-parole	NOM	porte-parole
de	PRP	de
l'	DET:ART	le
ambassade	NOM	ambassade
américaine	ADJ	américain
à	PRP	à
tel-aviv	NOM	tel-aviv
a	VER:pres	avoir
indiqué	VER:pper	indiquer
que	KON	que
«	PUN:cit	«
le	DET:ART	le
personnel	NOM	personnel
non	ADV	non
essentiel	ADJ	essentiel
a	VER:pres	avoir
été	VER:pper	être
autorisé	VER:pper	autoriser
à	PRP	à
partir	VER:infi	partir
»,	NOM	»,
précisant	VER:ppre	préciser
que	KON	que
les	DET:ART	le
départs	NOM	départ
allaient	VER:impf	aller
commencer	VER:infi	commencer
«	PUN:cit	«
au	PRP:det	au
milieu	NOM	milieu
de	PRP	de
la	DET:ART	le
semaine	NOM	semaine
».	ADJ	».
